**************
*            *
*       *    *
*   *   *    E
*   *        *
*S************