**********
*     *  *
*  *  *  E
*  *     *
*S********