**************
*            *
*       *    *
*   *   *    *
*   *        *
*E*********S**